20 20
2
3 1
2 1
####################
#S      #         1#
#       #          #
#       #          #
#       #          #
#       #          #
#       #          #
#       #          #
#       #          #
#       #          #
#       #          #
#       #          #
#       #          #
#       #          #
#       #          #
#  1    #         0#
#       #          #
#                  #
#0                 #
####################