20 20
2
1 2
2 2
####################
#0                S#
#                  #
#                  #
#                  #
#                  #
#                  #
#                  #
#                  #
#                  #
#                  #
#                  #
#                  #
#                  #
#                  #
#           #      #
#           #      #
#           #      #
#0         1#    1 #
####################