20 20
2
2 1
3 4
####################
#                  #
#            #######
#            #     #
#            # #   #
#            #0#   #
#    ###     ###   #
#    #0#           #
#   1# #           #
###### #           #
#                  #
#                  #
#                  #
####################
#1                 #
#                  #
#                  #
#           S      #
#                  #
####################